NO ./minecraft_wood.xpm
SO ./minecraft_leaf.xpm
WE ./kl_tower.xpm
EA ./as.xpm
DO ./minecraft_wood3.xpm

C 21,67,96
F 171,178,185


111111111111111111111111111111111
100000000000000000000000000000001
100001000000000000000000000000001
100011100000000000000000000000001
100001000010000000000100000000001
100000000011111111111100000000001
10000000001          100000000001
10000000001          100000000001
100000000011111111111100000000001
100000000010000000000100000000001
100000000000000000000000000000001
100000000000000000000000000000001
10000000000000000000000000000W001
111111111111111111111111111111111