NO ./as.xpm
SO ./kl_tower.xpm
WE ./minecraft_leaf.xpm
EA ./minecraft_wood.xpm
DO ./minecraft_wood3.xpm

C 21,67,96
F 171,178,185


111111111111111111111111111111111
100000000000000000000000000000001
100001000000000000000000000000001
100011100000000000000000000000001
100001000011111111111100000000001
10000000001          100000000001
10000000001          100000000001
10000000001          100000000001
10000000001          100000000001
100000000011111111111100000000001
100000000000000000000000000000001
100000000000000000000000000000001
10000000000000000000000000000N001
111111111111111111111111111111111