NO ./as.xpm
SO ./kl_tower.xpm
WE ./minecraft_leaf.xpm
EA ./minecraft_wood.xpm
DO ./minecraft_wood3.xpm

F 220,100,9
C 225,30,0

11111111
10000001
10101101
10000001
10000001
100N0101
10000001
10000001
10000001
10111101
11111111