NO ./as.xpm
SO ./kl_tower.xpm
WE ./minecraft_leaf.xpm
EA ./minecraft_wood.xpm
DO ./minecraft_wood3.xpm

C 230,253,131
F 183,219,247

 11111111111111
 100000000000001
10000001000000101
10000010100000101
1000000100W000001
 100000000000001
 111111111111111