NO ./minecraft_resource_pack_yellow.xpm
SO ./minecraft_resource_pack_diamondgreen.xpm
WE ./miao_miao.xpm
EA ./minecraft_resource_pack_red.xpm
DO ./minecraft_wood3.xpm

C 205,221,235
F 255,222,177

 111111111111
 100000000001
10000001000001
1000001 100001
10000001000001
 100000000N01
 111111111111