NO ./as.xpm
SO ./kl_tower.xpm
WE ./minecraft_leaf.xpm
EA ./minecraft_wood.xpm
DO ./minecraft_wood3.xpm

C 230,253,131
F 183,219,247

 111111111111
 100000000001
10000001000001
10000010100001
10000001000001
 100000000N01
 111111111111