NO ./as.xpm
SO ./kl_tower.xpm
WE ./minecraft_leaf.xpm
EA ./minecraft_wood.xpm
DO ./minecraft_wood3.xpm

F 220,100,0
C 225,30,0

        111111
        10S001
        100001
        100001
        100001
        100001
        100001
        100001
  111111100001111111
 11000000000000000011
1110000000000000000111
 11000001111100000011
  111111     1111111