NO ./dogs.xpm
SO ./as.xpm
WE ./nyc_boroughs.xpm
EA ./Malaysia_flag.xpm
DO ./minecraft_wood3.xpm

C 21,67,96
F 171,178,185


   111111          1111111
  10000001        100000001
 100000000111111111000000001
10000000001111111000000000001
 100000000011111000000000001
  1000000000111000000000001
   10000000000000000000001
    100000000000000000001
     1000000000000000001
      10000000000000001
       100000000000001
        1000000000001
         1000000N001
          100000001
           1000001
            10001
             111