NO ./as.xpm
SO ./kl_tower.xpm
WE ./minecraft_leaf.xpm
EA ./minecraft_wood.xpm
DO ./minecraft_wood3.xpm

F 220,100,0
C 225,30,0

111111111111111111111111111111111
100000000000000000000000000000001
10000000000000000000000000E000001
100000000000000000000000000000001
100000000000000000000000000000001
100000000000000000000000000000001
100000000000000011000000000000001
100000000000000010000000000000001
100000000000000011100000000000001
100000000000000000000000000000001
100000000000000000000000000000001
100000000000000000000000000000001
100000000000000000000000000000001
111111111111111111111111111111111
