NO ./as.xpm
SO ./kl_tower.xpm
WE ./minecraft_leaf.xpm
EA ./minecraft_wood.xpm
DO ./minecraft_wood3.xpm

F 248,241,240
C 131,186,253

111111111111111111111111111111111
100000000000000000000000000000001
10000000000000000000000000N000001
100000000000000000000000000000001
100000000000000000000000000000001
100000000000000000000000000000001
100000000000000011000000000000001
100000000000000010000000000000001
100000000000000011100000000000001
100000000000000000000000000000001
100000000000000000000000000000001
100000000000000000000000000000001
100000000000000000000000000000001
111111111111111111111111111111111
