NO ./as.xpm
SO ./minecraft_leaf.xpm
WE ./miao_miao.xpm
EA ./Malaysia_flag.xpm
DO ./minecraft_wood3.xpm

C 165,200,230
F 219,240,189

111111111111111111111111111111111
100000000000000000000000000000001
10000000000000000000000000W000001
100000000000000000000000000000001
100000000000000000000000000000001
100000000000000000000000000000001
100000000000000011000000000000001
100000000000000010000000000000001
100000000000000011100000000000001
100000000000000000000000000000001
100000000000000000000000000000001
100000000000000000000000000000001
100000000000000000000000000000001
111111111111111111111111111111111
