NO ./path_to_the_north_texture
SO ./path_to_the_south_texture
WE ./path_to_the_west_texture
EA ./path_to_the_east_texture

F 220,100,0
C 225,30,0


11111111111111111111111111111 
10000000000000000000000000001 
100000000000111111000001110011
111111111000111111000000111111
100000000000000000000000000001
100000000000000000000000000011
100001101101101101101101101101
111111111111111111111111111111