NO ./as.xpm
SO ./kl_tower.xpm
WE ./minecraft_leaf.xpm
EA ./minecraft_wood.xpm
DO ./minecraft_wood3.xpm

F 220,100,0
C 225,30,0


111111111111111111111111111111111
100000000000000000000000000000111
100000000000111111000001110000011
111111111000111111000000111110011
100000000000000000000000000001111
100000000000000000000000000011111
100001101101101101101101101101111
100000000000000000000000000001111
111110111111111111100001111100111
111100111111111111100001111001111
111111110000000000000000000000001
111111110000000000000000000000001
111111110000000000000000000000001
111111111111111111111111111111111