NO ./dogs.xpm
SO ./kl_tower.xpm
WE ./as.xpm
EA ./minecraft_wood.xpm
DO ./minecraft_wood3.xpm

C 86,231,156
F 227,122,99

        11111111111111111111111111
        1000000000110000000000001
        1011000001110000000000001
        1001000000000000000000001
111111111011000001110000000000001
100000000011000001110111110111111 
11110111111111011100000010001
11110111111111011101010010001
11000000110101011100000010001    
10000000000000000000000010001    
10000000000000001101010010N01    
110000011101010001101111100011
11110111 11101011101111110001
11111111 11111111111111111111