NO ./as.xpm
SO ./kl_tower.xpm
WE ./minecraft_leaf.xpm
EA ./minecraft_wood.xpm
DO ./minecraft_wood3.xpm

F 200,100,0
C 225,30,0

        11111111111111111111111111
        1000000000110000000000001
        1011000001110000000W00001
        1001000000000000000000001
111111111011000001110000000000001
100000000011000001110111110111111 
11110111111111011100000010001
11110111111111011101010010001
11000000110101011100000010001    
10000000000000000000000010001    
10000000000000001101010010001    
110000011101010001101111100011
11110111 11101011101111110001
11111111 11111111111111111111